1111111111111111111111
1C01000000000000000011
1000000C00000000000001
100000000000000C000001
1000000000000000000001
10000C0000000000000001
1000000000P00000000011
1000000000000000000001
111000000C000000000001
10100000000000000C01E1
1111111111111111111111
